1
11 15
10 7
###############
#...#...#.....#
###.#.#.#.###.#
#.#...#.......#
#.#####E###.#.#
#.....###.....#
#####.#.#.#####
#.#...#...#...#
#.#.#####.###.#
#.............#
#######.#######